111111111111111111111
1000000000000000001E1
101111011110111100101
101111C11110111100101
10111101111C111100101
101111011110111100101
100000000000000000001
100000000000000000001
100000000000000000001
101111011110111100101
10111101111C111100101
101111C11110111100101
101111011110111100101
1000000000000000001P1
111111111111111111111